111111111111111111111111111111
1P00000010000100000000000000E1
101111110101010111111111111101
1C0000101010001000000001000001
101110010111111011111110101111
1000100000000000001000101000C1
101010111111111110101110101111
100010000000001000100000100001
101110111101101111111111101101
1C0001000010000000000010000001
101110101111111111101111111101
1000001000000000001010000000C1
111111101111111111101011111101
1C0000000000000000000000000001
111111111111111111111111111111
